Practice Mixing
An Interactive Fiction by Shane Toma
Release 1 / Serial number 170227 / Inform 7 build 6M62 (I6/v6.33 lib 6/12N) SD

Example Location

>mix ingrediant
You can't combine nothing into anything useful.
Try another combination of ingredients.

>mix dough with cheese with sauce
I only understood you as far as wanting to mix.

>mix dough and cheese and sauce
I only understood you as far as wanting to mix.

>mix dough, sauce, cheese
I only understood you as far as wanting to mix.

>mix dough and sauce and cheese
I only understood you as far as wanting to mix.

>combine dough and sauce and cheese
That's not a verb I recognise.

>mix cheese
I only understood you as far as wanting to mix.

>mix dough
I only understood you as far as wanting to mix.

>mix dough and cheese
I only understood you as far as wanting to mix.

>mix ingredients
I only understood you as far as wanting to mix.

>mix things in pizza pallet
You can't combine nothing into anything useful.
Try another combination of ingredients.

>place cheese on pizza pallet
That's not a verb I recognise.

* * *

Practice Mixing
An Interactive Fiction by Shane Toma
Release 1 / Serial number 170227 / Inform 7 build 6M62 (I6/v6.33 lib 6/12N) SD

Example Location

>take all
You can't see any such thing.

>l
Example Location

>mix dough with sauce
I only understood you as far as wanting to mix.

>mix dough and sauce
I only understood you as far as wanting to mix.

>mix dough
I only understood you as far as wanting to mix.

>mix dough and sauce and cheese
I only understood you as far as wanting to mix.

>combine dough with sauce
That's not a verb I recognise.

>combine dough and sauce
That's not a verb I recognise.

>mix ingredients
I only understood you as far as wanting to mix.

>open box
You can't see any such thing.

* * *

Practice Mixing
An Interactive Fiction by Shane Toma
Release 1 / Serial number 170227 / Inform 7 build 6M62 (I6/v6.33 lib 6/12N) SD

Example Location

>x box
You can't see any such thing.