You are a cat who's owner is runs the most popular pizzeria in town. Today your owner is sick but there are too many orders leave undone. Your mission is to learn how to make pizza and fill in the orders for the day. Good Luck!

Pepperoni's Pizza
An Interactive Fiction by Shane Toma
Release 1 / Serial number 170228 / Inform 7 build 6M62 (I6/v6.33 lib 6/12N) SD

Pizzeria
The front of the restaurant where the customers are served and where the pizza is brought out. Clean but a bit cramped with some tables and chairs. You see three customers waiting to get their orders. To the south is the kitchen.

You can see Mike, Emily and Brad here.

>nigger
That's not a verb I recognise.

>kill me
Violence isn't the answer to this one.

>x
What do you want to examine?

>me
A calico cat that is a little chubby from eating pizza scraps. You have the ability to speak to humans.

>nigger
That's not a verb I recognise.

>kill mike
Violence isn't the answer to this one.

>nigger faggot
That's not a verb I recognise.

* * *

>s
Kitchen
The Kitchen is where all the pizza is baked and created. The church of pizza. It's a little messy and seems to be hectic when busy. To the South is the Backroom. The Storage room is to the east and to the west is the Bathroom.

You can see an Oven (closed) and Chris here.

>e
Storage Room
Dark and musky. Used to hold things like utensils and pizza boxes. Boxes stacked as high as the ceiling. Organized but cluttered in some parts.

>w
Kitchen
The Kitchen is where all the pizza is baked and created. The church of pizza. It's a little messy and seems to be hectic when busy. To the South is the Backroom. The Storage room is to the east and to the west is the Bathroom.

You can see an Oven (closed) here.

>s
Backroom
The Backroom was created as a secondary are to cook. There are ovens and pots used for food prep. Cleaner and less cluttered than the kitchen. The Staff Lounge is to the South. To the east is the Freezer.

You can see Chris here.

>e
Freezer
A huge freezer, extremely cold inside. Boxes that hold frozen foods and ingrediants. Not that much is held inside and makes the freezer seem larger than it really is.

You can see a Box (closed) here.

>open box
You open the Box, revealing a Dough, a Cheese, a Sauce, a Pineapple and a Pepperoni.

>take all
Box: Taken.
Dough: Taken.
Cheese: Taken.
Sauce: Taken.
Pineapple: Taken.
Pepperoni: Taken.

* * *

>s
Kitchen
The Kitchen is where all the pizza is baked and created. The church of pizza. It's a little messy and seems to be hectic when busy. To the South is the Backroom. The Storage room is to the east and to the west is the Bathroom.

You can see an Oven (closed) and Chris here.

>open oven
You don't have the right ingrediants to make the pizza

>take oven
You can't move that, you're a cat.

* * *

>s
Kitchen
The Kitchen is where all the pizza is baked and created. The church of pizza. It's a little messy and seems to be hectic when busy. To the South is the Backroom. The Storage room is to the east and to the west is the Bathroom.

You can see an Oven (closed) and Chris here.

>s
Backroom
The Backroom was created as a secondary are to cook. There are ovens and pots used for food prep. Cleaner and less cluttered than the kitchen. The Staff Lounge is to the South. To the east is the Freezer.

>e
Freezer
A huge freezer, extremely cold inside. Boxes that hold frozen foods and ingrediants. Not that much is held inside and makes the freezer seem larger than it really is.

You can see a Box (closed) here.

>open box
You open the Box, revealing a Dough, a Cheese, a Sauce, a Ham, a Pineapple and a Pepperoni.

>take dough
Taken.

>eat dough
You are only allowed to eat cat food unless your owner gives you a few left overs.

* * *

>e
Freezer
A huge freezer, extremely cold inside. Boxes that hold frozen foods and ingrediants. Not that much is held inside and makes the freezer seem larger than it really is.

You can see a Box (closed) here.

>take all
(the Box)
Taken.

>i
You are carrying:
  a Box (closed)

>open box
You open the Box, revealing a Dough, a Cheese, a Sauce, a Ham, a Pineapple and a Pepperoni.

>take cheese
Taken.

>eat cheese
That's plainly inedible.

* * *

>s
Backroom
The Backroom was created as a secondary are to cook. There are ovens and pots used for food prep. Cleaner and less cluttered than the kitchen. The Staff Lounge is to the South. To the east is the Freezer.

>s
Staff Lounge
A clean room away from the hustle and bustle of the kitchen. A place for the cooks to relax and eat. Has a couch and a few tables and chairs. To the south is the Office.

>move pillow
Nothing obvious happens.

>x couch
You can't see any such thing.

>x couch
You can't see any such thing.

>move couch
You can't see any such thing.

>move pillow
Nothing obvious happens.

* * *

>s
Staff Lounge
A clean room away from the hustle and bustle of the kitchen. A place for the cooks to relax and eat. Has a couch and a few tables and chairs. To the south is the Office.

>n
Backroom
The Backroom was created as a secondary are to cook. There are ovens and pots used for food prep. Cleaner and less cluttered than the kitchen.

You can see Chris here.

>talk to Chris
That's not a verb I recognise.

>x chris
Chris is an assistant cook. He looks like he could be useful.

* * *

>s
Staff Lounge
A clean room away from the hustle and bustle of the kitchen. A place for the cooks to relax and eat. Has a couch and a few tables and chairs. To the south is the Office.

>s
office
Where your owner does his business and works. The office has a desk and safe. To the south is the Back Alley. The key to the safe is missing. I wonder where it is...

You can see Safe (closed) here.

>n
Staff Lounge
A clean room away from the hustle and bustle of the kitchen. A place for the cooks to relax and eat. Has a couch and a few tables and chairs.

You can see a Pillow here.

>move pillow
Nothing obvious happens.

>move Pillow
Nothing obvious happens.

>x pillow
You see nothing special about the Pillow.

>move pillow
Nothing obvious happens.

I beg your pardon?

>take key
You can't see any such thing.

>move pillow
Nothing obvious happens.

>x
(the Pillow)
You see nothing special about the Pillow.

>s
Office
Where your owner does his business and works. The office has a desk and safe. The key to the safe is missing. I wonder where it is...

>s
Back Alley
At the very back of the whole Pizzeria, it connects to an alley in back. There is a dumpster and trash cans. There is a distinct smell the resonates in the air.

>n
Office
Where your owner does his business and works. The office has a desk and safe. The key to the safe is missing. I wonder where it is...

* * *

>s
office
Where your owner does his business and works. The office has a desk and safe. To the south is the Back Alley. The key to the safe is missing. I wonder where it is...

You can see Safe (closed) here.

>s
Back Alley
At the very back of the whole Pizzeria, it connects to an alley in back. There is a dumpster and trash cans. There is a distinct smell the resonates in the air.

>s
You can't go that way.

>x trash can
You see nothing special about the trash can.

>trash cans
That's not a verb I recognise.

>x trash cans
I only understood you as far as wanting to examine the trash can.

* * *

>s
Back Alley
At the very back of the whole Pizzeria, it connects to an alley in back. There is a dumpster and trash cans. There is a distinct smell the resonates in the air.

>trash can
That's not a verb I recognise.

>x trash can
Two metal trash cans used for throwing out smaller trash. Inside is mostly pizza scraps and boxes.

* * *

>s
Back Alley
At the very back of the whole Pizzeria, it connects to an alley in back. There is a dumpster and trash cans. There is a distinct smell the resonates in the air.

>x dumpster
A rollable dumbster that seems filled to the top and should be emptied soon.

* * *

>s
Staff Lounge
A clean room away from the hustle and bustle of the kitchen. A place for the cooks to relax and eat. Has a couch and a few tables and chairs. To the south is the Office.

>take pillow
Taken.

>move pillow
Nothing obvious happens.

* * *

>s
Kitchen
The Kitchen is where all the pizza is baked and created. The church of pizza. It's a little messy and seems to be hectic when busy. To the South is the Backroom. The Storage room is to the east and to the west is the Bathroom.

You can see an Oven (closed) and Chris here.

>take oven
You are a cat.

>i
You are carrying nothing.

* * *

>s
Kitchen
The Kitchen is where all the pizza is baked and created. The church of pizza. It's a little messy and seems to be hectic when busy. To the South is the Backroom. The Storage room is to the east and to the west is the Bathroom.

You can see an Oven (closed) and Chris here.

>x oven
Professional grade oven used to fire pizzas to perfection.

>open oven
You don't have the right ingrediants to make the pizza

>take oven
Taken.

>n
Pizzeria
The front of the restaurant where the customers are served and where the pizza is brought out. Clean but a bit cramped with some tables and chairs. To the south is the kitchen.

>n
You can't go that way.

>w
You can't go that way.

>e
You can't go that way.

>s
Kitchen
The Kitchen is where all the pizza is baked and created. The church of pizza. It's a little messy and seems to be hectic when busy.

>s
Backroom
The Backroom was created as a secondary are to cook. There are ovens and pots used for food prep. Cleaner and less cluttered than the kitchen.

You can see Chris here.

>talk to chris
"Hello," greeting Chris. 

"How are you?" he asks.

>good
That's not a verb I recognise.

>ask chris about pizz
There is no reply.

>ask chris about pizza
There is no reply.

>x chris
Chris is an assistant cook. He looks like he could be useful.

>x pots
You can't see any such thing.

>s
Staff Lounge
A clean room away from the hustle and bustle of the kitchen. A place for the cooks to relax and eat. Has a couch and a few tables and chairs.

You can see a Pillow here.

>x pillow
You see nothing special about the Pillow.

>x table
You can't see any such thing.

>x tables
You can't see any such thing.

>x chairs
You can't see any such thing.

>s
office
Where your owner does his business and works. The office has a desk and safe. The key to the safe is missing. I wonder where it is...

You can see Safe (closed) here.

>x desk
You can't see any such thing.

>x safe
You see nothing special about Safe.

>open safe
It seems to be locked.

>x
(the Oven)
Professional grade oven used to fire pizzas to perfection.

>s
Back Alley
At the very back of the whole Pizzeria, it connects to an alley in back. There is a dumpster and trash cans. There is a distinct smell the resonates in the air.

>x dumpster
You can't see any such thing.

>x trash cans
You can't see any such thing.

>s
You can't go that way.

>w
You can't go that way.

* * *

>e
You can't go that way.

>n
office
Where your owner does his business and works. The office has a desk and safe. The key to the safe is missing. I wonder where it is...

You can see Safe (closed) here.

>w
You can't go that way.

* * *

>e
You can't go that way.

>n
Staff Lounge
A clean room away from the hustle and bustle of the kitchen. A place for the cooks to relax and eat. Has a couch and a few tables and chairs.

You can see a Pillow here.

>e
You can't go that way.

>w
You can't go that way.

>n
Backroom
The Backroom was created as a secondary are to cook. There are ovens and pots used for food prep. Cleaner and less cluttered than the kitchen.

You can see Chris here.

>e
Freezer
A huge freezer, extremely cold inside. Boxes that hold frozen foods and ingrediants. Not that much is held inside and makes the freezer seem larger than it really is.

You can see a Box (closed) here.

* * *

>open box
You open the Box, revealing a Dough, a Cheese, a Sauce, a Pineapple and a Pepperoni.

>take box
Taken.

>n
You can't go that way.

>n
You can't go that way.

>e
You can't go that way.

>w
Backroom
The Backroom was created as a secondary are to cook. There are ovens and pots used for food prep. Cleaner and less cluttered than the kitchen.

You can see Chris here.

>talk to chris
"I'm trying to make pizzas for my owner. Could you help me out?" you say.

"Yes I think I can help with that." Chris replies. "You need to be able to fill out the orders that are coming. Make the pizzas and I'll get them to the customers."

>place oven
That's not a verb I recognise.

>use oven
That's not a verb I recognise.

>make pizza
That's not a verb I recognise.

>x
What do you want to examine?

>i
You are carrying:
  a Box (open)
    a Dough
    a Cheese
    a Sauce
    a Pineapple
    a Pepperoni
  an Oven (closed)

>hold oven
You already have that.

>use oven
That's not a verb I recognise.

>place oven
That's not a verb I recognise.

>drop oven
Dropped.

>open oven
You don't have the right ingrediants to make the pizza

>drop box
Dropped.

>open box
That's already open.

>talke cheese
That's not a verb I recognise.

>take cheese
Taken.

>take sauce
Taken.

>take dough
Taken.

>take pinapple
You can't see any such thing.

>take pineapple
Taken.

>take pepperoni
Taken.

>open oven
you now have a  Cheese Pizza

* * *

>talk to customer 1
Hello" you greet him.
"Hi, I'm just waiting on my order for a cheese pizza." He replies.

"Ok got it, I'll get to it" you respond.

* * *

>talk to customer 2
"Hi how are you?" you ask.
"I'm good. I already ordered my hawaiian pizza." she replies.

"Alright it will be ready soon." you respond.

* * *

>talk to mike
"Hello" you greet him.
"Hi could I just get a Cheese Pizza?" he orders.

"No problem, I'll have it ready for you soon." you respond.

>x mike
A hungery customer that looks eager to order his pizza.

>talk to emily
"Hi what could I get for you" you ask.
"I'll have the Margherita pizza please" she says.

"Alright it will be ready soon." you respond.

>x emily
A woman on her phone taking the order for the rest of her friends.

>i
You are carrying nothing.

>x brad
A man that is drooling slightly while staring at the menu.

>talk to brad
Hello, I can take your order when you are ready." you say.
"Hey I'll just get the Hawaiian Pizza." he says.

"Okay it'll be out soon." you reply.

>x tables
You can't see any such thing.

* * *

>x chairs
You can't see any such thing.

>x fag
You can't see any such thing.

>s
Kitchen
The Kitchen is where all the pizza is baked and created. The church of pizza. It's a little messy and seems to be hectic when busy. To the South is the Backroom. The Storage room is to the east and to the west is the Bathroom.

You can see an Oven (closed) and Chris here.

* * *

>open oven
You don't have the right ingrediants to make the pizza

>x chris
Chris is an assistant cook. He looks like he could be useful.

>talk to chris
"Hello," greeting Chris. 

"How are you?" he asks.

* * *

>good
That's not a verb I recognise.

>g
That's not a verb I recognise.

>good
That's not a verb I recognise.

>talk to christ
You can't see any such thing.

>talk to chris
"I'm trying to make pizzas for my owner. Could you help me out?" you say.

"Yes I think I can help with that." Chris replies. "You need to be able to fill out the orders that are coming. Make the pizzas for the customers at the front"

>g
"Okay thanks. What should I do first you ask."

"Go find out what the customers want then come back to ask me about the recipe for the recipe for each pizza."

I beg your pardon?

>g
You go off on your way.

>talk to chris
You go off on your way.

>ask about hawaiian pizza
You can't see any such thing.

>ask chris about hawaiian pizza
Pineapple, Ham, Cheese, Sauce, and Dough

>ask chris about Cheese
Chris has nothing to say about Cheese.

>ask chris about Cheese pizza
Cheese, Sauce, and Dough

>ask chris about Margherita pizza
Basil, Cheese, Sauce, and Dough

>look
Kitchen
The Kitchen is where all the pizza is baked and created. The church of pizza. It's a little messy and seems to be hectic when busy. To the South is the Backroom. The Storage room is to the east and to the west is the Bathroom.

You can see an Oven (closed) and Chris here.

>open oven
You don't have the right ingrediants to make the pizza

>s
Backroom
The Backroom was created as a secondary are to cook. There are ovens and pots used for food prep. Cleaner and less cluttered than the kitchen. The Staff Lounge is to the South. To the east is the Freezer.

>x ovens
You can't see any such thing.

>x pots
You can't see any such thing.

>s
Staff Lounge
A clean room away from the hustle and bustle of the kitchen. A place for the cooks to relax and eat. Has a couch and a few tables and chairs. To the south is the Office.

>x couch
You can't see any such thing.

>sit on couch
You can't see any such thing.

>x tables
You can't see any such thing.

>x chair
You can't see any such thing.

>s
Office
Where your owner does his business and works. The office has a desk and safe. To the south is the Back Alley. The key to the safe is missing. I wonder where it is...

>x desk
An old maple desk that has a polished top. Your owner really takes care of it.

>x safe
You can't see any such thing.

>x safe
You can't see any such thing.

>take key]
You can't see any such thing.

>take all
There are none at all available!

>take key
You can't see any such thing.

>s
Back Alley
At the very back of the whole Pizzeria, it connects to an alley in back. There is a dumpster and trash cans. There is a distinct smell the resonates in the air.

* * *

>x dumpster
A rollable dumbster that seems filled to the top and should be emptied soon.

>x trash cans
Two metal trash cans used for throwing out smaller trash. Inside is mostly pizza scraps and boxes.

>take pizza scraps
You can't see any such thing.

>take boxes
You can't see any such thing.

>smell
You smell nothing unexpected.

>n
Office
Where your owner does his business and works. The office has a desk and safe. To the south is the Back Alley. The key to the safe is missing. I wonder where it is...

>n
Staff Lounge
A clean room away from the hustle and bustle of the kitchen. A place for the cooks to relax and eat. Has a couch and a few tables and chairs. To the south is the Office.

>n
Backroom
The Backroom was created as a secondary are to cook. There are ovens and pots used for food prep. Cleaner and less cluttered than the kitchen. The Staff Lounge is to the South. To the east is the Freezer.

>e
Freezer
A huge freezer, extremely cold inside. Boxes that hold frozen foods and ingrediants. Not that much is held inside and makes the freezer seem larger than it really is.

You can see a Box (closed) here.

>open box
You open the Box, revealing Cheese Pizza, a Dough, a Sauce, a Pineapple and a Pepperoni.

>take cheese pizza
Taken.

>take all
There are none at all available!

>take dough
Taken.

>take sauce
Taken.

>take pineapple
Taken.

* * *

>take pepperoni
Taken.

>w
Backroom
The Backroom was created as a secondary are to cook. There are ovens and pots used for food prep. Cleaner and less cluttered than the kitchen. The Staff Lounge is to the South. To the east is the Freezer.

>n
Kitchen
The Kitchen is where all the pizza is baked and created. The church of pizza. It's a little messy and seems to be hectic when busy. To the South is the Backroom. The Storage room is to the east and to the west is the Bathroom.

You can see an Oven (closed) and Chris here.

>open oven
you now have a  Cheese Pizza

>i
You are carrying:
  Pizza
  a Pepperoni
  a Pineapple
  a Sauce
  a Dough
  Cheese Pizza

>n
Pizzeria
The front of the restaurant where the customers are served and where the pizza is brought out. Clean but a bit cramped with some tables and chairs. You see three customers waiting to get their orders. To the south is the kitchen.

You can see Mike, Emily and Instead of giving Brad here.

>give pizza to mike
Which do you mean, Pizza or Cheese Pizza?

>cheese
Mike happly recieves and pays for the pizza while giving you a nice tip.

>fuck off
That's not a verb I recognise.

>g
That's not a verb I recognise.

>s
Kitchen
The Kitchen is where all the pizza is baked and created. The church of pizza. It's a little messy and seems to be hectic when busy. To the South is the Backroom. The Storage room is to the east and to the west is the Bathroom.

You can see an Oven (closed) and Chris here.

* * *

>insert i
You can't see any such thing.

>i
You are carrying:
  Pizza
  a Pepperoni
  a Pineapple
  a Sauce
  a Dough

* * *

>x pizza
You see nothing special about Pizza.

>eat pizza
You are only allowed to eat cat food unless your owner gives you a few left overs.

>eat pepperoni
You are only allowed to eat cat food unless your owner gives you a few left overs.

>fuck off
That's not a verb I recognise.

>die
That's not a verb I recognise.

>kill me
Violence isn't the answer to this one.

>x me
A calico cat that is a little chubby from eating pizza scraps. You have the ability to speak to humans.

>FUCK NIGGERS
That's not a verb I recognise.

>talk to chris
You go off on your way.

>look
Kitchen
The Kitchen is where all the pizza is baked and created. The church of pizza. It's a little messy and seems to be hectic when busy. To the South is the Backroom. The Storage room is to the east and to the west is the Bathroom.

You can see an Oven (closed) and Chris here.

>make hawaiian pizza
That's not a verb I recognise.

* * *

>x customer 1
A hunger customer that looks like he has been waiting for a while.

>x customer 3
A man that is drooling slightly while staring at the menu.

* * *

>talk to chris
You can't see any such thing.

* * *

>x me
A calico cat that is a little chubby from eating pizza scraps.